+------------------------------------------------------------------------------------------+
|..........................................................................................|
|..........................................................................................|
|..........................................................................................|
|..........................................................................................|
|..........................................................................................|
|..........................................................................................|
|..........................................................................................|
|......................+...........................................+.......................|
|......................|...........................................|.......................|
|......................|...........................................|.......................|
|......................|...........................................|.......................|
|......................|...........................................|.......................|
|......................|...........................................|.......................|
|......................|...........................................|.......................|
|......................|...........................................|.......................|
|......................|...........................................|.......................|
|......................|...........................................|.......................|
|......................|...........................................|.......................|
|......................|...........................................|.......................|
|......................|...........................................|.......................|
|......................|...........................................|.......................|
|......................|...........................................|.......................|
|......................|...........................................|.......................|
|......................|...........................................|.......................|
|......................|...........................................|.......................|
|......................|...........................................|.......................|
|......................|...........................................|.......................|
|......................|...........................................|.......................|
|......................|...........................................|.......................|
|......................|...........................................|.......................|
|......................|...........................................|.......................|
|......................|...........................................|.......................|
|......................|...........................................|.......................|
|......................|...........................................|.......................|
|......................|...........................................|.......................|
|......................|...........................................|.......................|
|......................|...........................................|.......................|
|......................|...........................................|.......................|
|......................|...........................................|.......................|
|......................|...........................................|.......................|
|......................|...........................................|.......................|
|......................|...........................................|.......................|
|......................|...........................................|.......................|
|......................|...........................................|.......................|
|......................|...........................................|.......................|
|......................|...........................................|.......................|
|......................|...........................................|.......................|
|......................|...........................................|.......................|
|......................|...........................................|.......................|
|......................|...........................................|.......................|
|......................|...........................................|.......................|
|......................|...........................................|.......................|
|......................|...........................................|.......................|
|......................|...........................................|.......................|
|......................|...........................................|.......................|
|......................|...........................................|.......................|
|......................+...........................................+.......................|
|..........................................................................................|
|..........................................................................................|
|..........................................................................................|
|..........................................................................................|
|..........................................................................................|
|..........................................................................................|
|..........................................................................................|
+------------------------------------------------------------------------------------------+