.............................................||.............................................
.............................................||.............................................
.............................................||.............................................
.............................................||.............................................
.............................................||.............................................
.............................................||.............................................
.............................................||.............................................
.............................................||.............................................
.............................................||.............................................
.............................................||.............................................
.............................................||.............................................
.............................................||.............................................
.............................................||.............................................
.............................................||.............................................
.............................................||.............................................
.............................................||.............................................
.............................................||.............................................
.............................................||.............................................
.............................................||.............................................
.............................................||.............................................
.............................................||.............................................
.............................................||.............................................
.............................................||.............................................
.............................................||.............................................
.............................................||.............................................
.............................................||.............................................
.............................................||.............................................
.............................................||.............................................
.............................................||.............................................
.............................................||.............................................
.............................................||.............................................
.............................................||.............................................
---------------------------------------------][---------------------------------------------
---------------------------------------------}{---------------------------------------------
.............................................||.............................................
.............................................||.............................................
.............................................||.............................................
.............................................||.............................................
.............................................||.............................................
.............................................||.............................................
.............................................||.............................................
.............................................||.............................................
.............................................||.............................................
.............................................||.............................................
.............................................||.............................................
.............................................||.............................................
.............................................||.............................................
.............................................||.............................................
.............................................||.............................................
.............................................||.............................................
.............................................||.............................................
.............................................||.............................................
.............................................||.............................................
.............................................||.............................................
.............................................||.............................................
.............................................||.............................................
.............................................||.............................................
.............................................||.............................................
.............................................||.............................................
.............................................||.............................................
.............................................||.............................................
.............................................||.............................................
.............................................||.............................................
.............................................||.............................................
.............................................||.............................................
.............................................||.............................................