+------------------+-----------------------------------------------------------------------+
|..................|.......................................................................|
|..................|.......................................................................|
|..................|.......................................................................|
|..................|.......................................................................|
|..................|.......................................................................|
|..................|.......................................................................|
|..................|.......................................................................|
|..................|.......................................................................|
|..................|.......................................................................|
|..................|.......................................................................|
|..................|.......................................................................|
|..................|.......................................................................|
|..................|.......................................................................|
|..................|.....................+-------------------------------------------------+
|..................|.......................................................................|
|..................|.......................................................................|
|..................|.......................................................................|
|..................|.......................................................................|
|..................|.......................................................................|
|..................|.......................................................................|
|..................|.......................................................................|
|..................|.......................................................................|
|..................|.......................................................................|
|..................|.......................................................................|
|..................|.......................................................................|
|..................|.......................................................................|
|..................|...................................................+...................|
|..................|...................................................|...................|
|..................|...................................................|...................|
|..................|...................................................|...................|
|..................|...................................................|...................|
|..................|...................................................|...................|
|..................|...................................................|...................|
|..................|...................................................|...................|
|..................|...................................................|...................|
|..................|...................................................|...................|
|..................+...................................................|...................|
|......................................................................|...................|
|......................................................................|...................|
|......................................................................|...................|
|......................................................................|...................|
|......................................................................|...................|
|......................................................................|...................|
|......................................................................|...................|
|......................................................................|...................|
|......................................................................|...................|
|......................................................................|...................|
|......................................................................|...................|
|......................................................................|...................|
|......................................................................|...................|
+-------------------------------------------------+....................|...................|
|......................................................................|...................|
|......................................................................|...................|
|......................................................................|...................|
|......................................................................|...................|
|......................................................................|...................|
|......................................................................|...................|
|......................................................................|...................|
|......................................................................|...................|
|......................................................................|...................|
|......................................................................|...................|
|......................................................................|...................|
|......................................................................|...................|
|......................................................................|...................|
+----------------------------------------------------------------------+-------------------+