+---------+---------+---------+---------+----------+---------+---------+---------+---------+
|.........|.........|.........|.........|..........|.........|.........|.........|.........|
|.........|.........|.........|.........|..........|.........|.........|.........|.........|
|.........|.........|.........|.........|..........|.........|.........|.........|.........|
|.........|.........|.........|.........|..........|.........|.........|.........|.........|
|.........|.........|.........|.........|..........|.........|.........|.........|.........|
|.........|.........|.........|.........|..........|.........|.........|.........|.........|
|.........|.........|.........|.........|..........|.........|.........|.........|.........|
|.........|.........|.........|.........|..........|.........|.........|.........|.........|
|.........|.........|.........|.........|..........|.........|.........|.........|.........|
|.........|.........|.........|.........|..........|.........|.........|.........|.........|
|.........|.........|.........|.........|..........|.........|.........|.........|.........|
|.........|.........|.........|.........|..........|.........|.........|.........|.........|
|.........|.........|.........|.........|..........|.........|.........|.........|.........|
|.........|.........|.........|.........|..........|.........|.........|.........|.........|
|.........|.........|.........|.........|..........|.........|.........|.........|.........|
|.........|.........|.........|.........|..........|.........|.........|.........|.........|
|.........|.........|.........|.........|..........|.........|.........|.........|.........|
|.........|.........|.........|.........|..........|.........|.........|.........|.........|
|.........|.........|.........|.........|..........|.........|.........|.........|.........|
|.........|.........|.........|.........|..........|.........|.........|.........|.........|
|.........|.........|.........|.........|..........|.........|.........|.........|.........|
|.........|.........|.........|.........|..........|.........|.........|.........|.........|
|.........|.........|.........|.........|..........|.........|.........|.........|.........|
|.........|.........|.........|.........|..........|.........|.........|.........|.........|
|.........|.........|.........|.........|..........|.........|.........|.........|.........|
|.........|.........|.........|.........|..........|.........|.........|.........|.........|
|.........+.........+.........+.........+..........+.........+.........+.........+.........|
|..........................................................................................|
|..........................................................................................|
|..........................................................................................|
|..........................................................................................|
|..........................................................................................|
|..........................................................................................|
|..........................................................................................|
|..........................................................................................|
|..........................................................................................|
|..........................................................................................|
|.........+.........+.........+.........+..........+.........+.........+.........+.........|
|.........|.........|.........|.........|..........|.........|.........|.........|.........|
|.........|.........|.........|.........|..........|.........|.........|.........|.........|
|.........|.........|.........|.........|..........|.........|.........|.........|.........|
|.........|.........|.........|.........|..........|.........|.........|.........|.........|
|.........|.........|.........|.........|..........|.........|.........|.........|.........|
|.........|.........|.........|.........|..........|.........|.........|.........|.........|
|.........|.........|.........|.........|..........|.........|.........|.........|.........|
|.........|.........|.........|.........|..........|.........|.........|.........|.........|
|.........|.........|.........|.........|..........|.........|.........|.........|.........|
|.........|.........|.........|.........|..........|.........|.........|.........|.........|
|.........|.........|.........|.........|..........|.........|.........|.........|.........|
|.........|.........|.........|.........|..........|.........|.........|.........|.........|
|.........|.........|.........|.........|..........|.........|.........|.........|.........|
|.........|.........|.........|.........|..........|.........|.........|.........|.........|
|.........|.........|.........|.........|..........|.........|.........|.........|.........|
|.........|.........|.........|.........|..........|.........|.........|.........|.........|
|.........|.........|.........|.........|..........|.........|.........|.........|.........|
|.........|.........|.........|.........|..........|.........|.........|.........|.........|
|.........|.........|.........|.........|..........|.........|.........|.........|.........|
|.........|.........|.........|.........|..........|.........|.........|.........|.........|
|.........|.........|.........|.........|..........|.........|.........|.........|.........|
|.........|.........|.........|.........|..........|.........|.........|.........|.........|
|.........|.........|.........|.........|..........|.........|.........|.........|.........|
|.........|.........|.........|.........|..........|.........|.........|.........|.........|
|.........|.........|.........|.........|..........|.........|.........|.........|.........|
|.........|.........|.........|.........|..........|.........|.........|.........|.........|
+---------+---------+---------+---------+----------+---------+---------+---------+---------+