+------------------------------------------------------------------------------------------+
|..........................................................................................|
|............................................{}............................................|
|............................................[]............................................|
|..........................................................................................|
|............................................{}............................................|
|............................................[]............................................|
|..........................................................................................|
|............................................{}............................................|
|............................................[]............................................|
|..........................................................................................|
|............................................{}............................................|
|............................................[]............................................|
|..........................................................................................|
|............................................{}............................................|
|............................................[]............................................|
|..........................................................................................|
|............................................{}............................................|
|............................................[]............................................|
|..........................................................................................|
|............................................{}............................................|
|............................................[]............................................|
|..........................................................................................|
|............................................{}............................................|
|............................................[]............................................|
|..........................................................................................|
|............................................{}............................................|
|............................................[]............................................|
|..........................................................................................|
|............................................{}............................................|
|............................................[]............................................|
|..........................................................................................|
|............................................{}............................................|
|............................................[]............................................|
|..........................................................................................|
|............................................{}............................................|
|............................................[]............................................|
|..........................................................................................|
|............................................{}............................................|
|............................................[]............................................|
|..........................................................................................|
|............................................{}............................................|
|............................................[]............................................|
|..........................................................................................|
|............................................{}............................................|
|............................................[]............................................|
|..........................................................................................|
|............................................{}............................................|
|............................................[]............................................|
|..........................................................................................|
|............................................{}............................................|
|............................................[]............................................|
|..........................................................................................|
|............................................{}............................................|
|............................................[]............................................|
|..........................................................................................|
|............................................{}............................................|
|............................................[]............................................|
|..........................................................................................|
|............................................{}............................................|
|............................................[]............................................|
|..........................................................................................|
|............................................{}............................................|
|............................................[]............................................|
|..........................................................................................|
+------------------------------------------------------------------------------------------+