......................................................................|.....................
......................................................................|.....................
......................................................................|.....................
......................................................................|.....................
......................................................................|.....................
......................................................................|.....................
......................................................................|.....................
......................................................................|.....................
......................................................................|.....................
......................................................................|.....................
------------------------------------------------+.....................+---------------------
......................................................................|.....................
......................................................................|.....................
......................................................................|.....................
......................................................................|.....................
......................................................................|.....................
......................................................................|.....................
......................................................................|.....................
......................................................................|.....................
......................................................................|.....................
......................................................................|.....................
----------------------------------------------------------------------+.....................
......................................................................|.....................
......................................................................|.....................
......................................................................|.....................
......................................................................|.....................
......................................................................|.....................
......................................................................|.....................
......................................................................|.....................
......................................................................|.....................
......................................................................|.....................
......................................................................|.....................
------------------------------------------------+.....................+---------------------
......................................................................|.....................
......................................................................|.....................
......................................................................|.....................
......................................................................|.....................
......................................................................|.....................
......................................................................|.....................
......................................................................|.....................
......................................................................|.....................
......................................................................|.....................
......................................................................|.....................
----------------------------------------------------------------------+.....................
......................................................................|.....................
......................................................................|.....................
......................................................................|.....................
......................................................................|.....................
......................................................................|.....................
......................................................................|.....................
......................................................................|.....................
......................................................................|.....................
......................................................................|.....................
......................................................................|.....................
------------------------------------------------+.....................+---------------------
......................................................................|.....................
......................................................................|.....................
......................................................................|.....................
......................................................................|.....................
......................................................................|.....................
......................................................................|.....................
......................................................................|.....................
......................................................................|.....................
......................................................................|.....................
......................................................................|.....................
----------------------------------------------------------------------+.....................