+------------------------------------------------------------------------------------------+
|..........................................................................................|
|..........................................................................................|
|..........................................................................................|
|..........................................................................................|
|..........................................................................................|
|..........................................................................................|
|..........................................................................................|
|..........................................................................................|
|..........................................................................................|
|..........................................................................................|
|.........................+--------------------------------------+.........................|
|..........................................................................................|
|..........................................................................................|
|..........................................................................................|
|....................+................................................+....................|
|....................|................................................|....................|
|....................|................................................|....................|
|....................|................................................|....................|
|....................|................................................|....................|
|....................|................................................|....................|
|....................|................................................|....................|
|....................|................................................|....................|
|....................|................................................|....................|
|....................|................................................|....................|
|....................|................................................|....................|
|....................|................................................|....................|
|....................|................................................|....................|
|....................|................................................|....................|
|....................|................................................|....................|
|....................|................................................|....................|
|....................|................................................|....................|
|....................|................................................|....................|
|....................|................................................|....................|
|....................|................................................|....................|
|....................|................................................|....................|
|....................|................................................|....................|
|....................|................................................|....................|
|....................|................................................|....................|
|....................|................................................|....................|
|....................|................................................|....................|
|....................|................................................|....................|
|....................|................................................|....................|
|....................|................................................|....................|
|....................|................................................|....................|
|....................|................................................|....................|
|....................|................................................|....................|
|....................|................................................|....................|
|....................|................................................|....................|
|....................+................................................+....................|
|..........................................................................................|
|..........................................................................................|
|..........................................................................................|
|.........................+--------------------------------------+.........................|
|..........................................................................................|
|..........................................................................................|
|..........................................................................................|
|..........................................................................................|
|..........................................................................................|
|..........................................................................................|
|..........................................................................................|
|..........................................................................................|
|..........................................................................................|
|..........................................................................................|
|..........................................................................................|
+------------------------------------------------------------------------------------------+