+----------+-------------------+------------------+-------------------+--------------------+
|..........|...................|..................|...................|....................|
|..........|...................|..................|...................|....................|
|..........|...................|..................|...................|....................|
|..........|...................|..................|...................|....................|
|..........|...................|..................|...................|....................|
|..........|...................|..................|...................|....................|
|..........|...................|..................|...................|....................|
|..........|...................|..................|...................|....................|
|..........|...................|..................|...................|....................|
|..........|...................|..................|...................|....................|
|..........|.........+.........|.........+........|.........+.........|.........+..........|
|..........|.........|.........|.........|........|.........|.........|.........|..........|
|..........|.........|.........|.........|........|.........|.........|.........|..........|
|..........|.........|.........|.........|........|.........|.........|.........|..........|
|..........|.........|.........|.........|........|.........|.........|.........|..........|
|..........|.........|.........|.........|........|.........|.........|.........|..........|
|..........|.........|.........|.........|........|.........|.........|.........|..........|
|..........|.........|.........|.........|........|.........|.........|.........|..........|
|..........|.........|.........|.........|........|.........|.........|.........|..........|
|..........|.........|.........|.........|........|.........|.........|.........|..........|
|..........|.........|.........|.........|........|.........|.........|.........|..........|
|..........|.........|.........|.........|........|.........|.........|.........|..........|
|..........|.........|.........|.........|........|.........|.........|.........|..........|
|..........|.........|.........|.........|........|.........|.........|.........|..........|
|..........|.........|.........|.........|........|.........|.........|.........|..........|
|..........|.........|.........|.........|........|.........|.........|.........|..........|
|..........|.........+.........|.........+........|.........+.........|.........+..........|
|..........|...................|..................|...................|....................|
|..........|...................|..................|...................|....................|
|..........|...................|..................|...................|....................|
|..........|...................|..................|...................|....................|
|..........|...................|..................|...................|....................|
|..........|...................|..................|...................|....................|
|..........|...................|..................|...................|....................|
|..........|...................|..................|...................|....................|
|..........|...................|..................|...................|....................|
|..........|...................|..................|...................|....................|
|..........|.........+.........|.........+........|.........+.........|.........+..........|
|..........|.........|.........|.........|........|.........|.........|.........|..........|
|..........|.........|.........|.........|........|.........|.........|.........|..........|
|..........|.........|.........|.........|........|.........|.........|.........|..........|
|..........|.........|.........|.........|........|.........|.........|.........|..........|
|..........|.........|.........|.........|........|.........|.........|.........|..........|
|..........|.........|.........|.........|........|.........|.........|.........|..........|
|..........|.........|.........|.........|........|.........|.........|.........|..........|
|..........|.........|.........|.........|........|.........|.........|.........|..........|
|..........|.........|.........|.........|........|.........|.........|.........|..........|
|..........|.........|.........|.........|........|.........|.........|.........|..........|
|..........|.........|.........|.........|........|.........|.........|.........|..........|
|..........|.........|.........|.........|........|.........|.........|.........|..........|
|..........|.........|.........|.........|........|.........|.........|.........|..........|
|..........|.........|.........|.........|........|.........|.........|.........|..........|
|..........|.........|.........|.........|........|.........|.........|.........|..........|
|..........+.........|.........+.........|........+.........|.........+.........|..........|
|....................|...................|..................|...................|..........|
|....................|...................|..................|...................|..........|
|....................|...................|..................|...................|..........|
|....................|...................|..................|...................|..........|
|....................|...................|..................|...................|..........|
|....................|...................|..................|...................|..........|
|....................|...................|..................|...................|..........|
|....................|...................|..................|...................|..........|
|....................|...................|..................|...................|..........|
|....................|...................|..................|...................|..........|
+--------------------+-------------------+------------------+-------------------+----------+