{------------------------------------------------------------------------------------------}
|..........................................................................................|
|.........{----------------------------------------------------------------------}.........|
|.........|{--------}{--------}{--------}{--------}{--------}{--------}{--------}|.........|
|.........||........||........||........||........||........||........||........||.........|
|.........||........||........||........||........||........||........||........||.........|
|.........[]........[]........[]........[]........[]........[]........[]........[].........|
|..........................................................................................|
|..........................................................................................|
|..........................................................................................|
|..........................................................................................|
|.........{}........{}........{}........{}........{}........{}........{}........{}.........|
|.........||........||........||........||........||........||........||........||.........|
|.........||........||........||........||........||........||........||........||.........|
|.........|[-}....{-][-}....{-][-}....{-][-}....{-][-}....{-][-}....{-][-}....{-]|.........|
|.........|{-]....[-}{-]....[-}{-]....[-}{-]....[-}{-]....[-}{-]....[-}{-]....[-}|.........|
|.........||........||........||........||........||........||........||........||.........|
|.........||........||........||........||........||........||........||........||.........|
|.........[]........[]........[]........[]........[]........[]........[]........[].........|
|..........................................................................................|
|..........................................................................................|
|..........................................................................................|
|..........................................................................................|
|.........{}........{}........{}........{}........{}........{}........{}........{}.........|
|.........||........||........||........||........||........||........||........||.........|
|.........||........||........||........||........||........||........||........||.........|
|.........|[-}....{-][-}....{-][-}....{-][-}....{-][-}....{-][-}....{-][-}....{-]|.........|
|.........|{-]....[-}{-]....[-}{-]....[-}{-]....[-}{-]....[-}{-]....[-}{-]....[-}|.........|
|.........||........||........||........||........||........||........||........||.........|
|.........||........||........||........||........||........||........||........||.........|
|.........[]........[]........[]........[]........[]........[]........[]........[].........|
|..........................................................................................|
|..........................................................................................|
|..........................................................................................|
|..........................................................................................|
|.........{}........{}........{}........{}........{}........{}........{}........{}.........|
|.........||........||........||........||........||........||........||........||.........|
|.........||........||........||........||........||........||........||........||.........|
|.........|[-}....{-][-}....{-][-}....{-][-}....{-][-}....{-][-}....{-][-}....{-]|.........|
|.........|{-]....[-}{-]....[-}{-]....[-}{-]....[-}{-]....[-}{-]....[-}{-]....[-}|.........|
|.........||........||........||........||........||........||........||........||.........|
|.........||........||........||........||........||........||........||........||.........|
|.........[]........[]........[]........[]........[]........[]........[]........[].........|
|..........................................................................................|
|..........................................................................................|
|..........................................................................................|
|..........................................................................................|
|.........{}........{}........{}........{}........{}........{}........{}........{}.........|
|.........||........||........||........||........||........||........||........||.........|
|.........||........||........||........||........||........||........||........||.........|
|.........|[-}....{-][-}....{-][-}....{-][-}....{-][-}....{-][-}....{-][-}....{-]|.........|
|.........|{-]....[-}{-]....[-}{-]....[-}{-]....[-}{-]....[-}{-]....[-}{-]....[-}|.........|
|.........||........||........||........||........||........||........||........||.........|
|.........||........||........||........||........||........||........||........||.........|
|.........[]........[]........[]........[]........[]........[]........[]........[].........|
|..........................................................................................|
|..........................................................................................|
|..........................................................................................|
|..........................................................................................|
|.........{}........{}........{}........{}........{}........{}........{}........{}.........|
|.........||........||........||........||........||........||........||........||.........|
|.........||........||........||........||........||........||........||........||.........|
|.........|[--------][--------][--------][--------][--------][--------][--------]|.........|
|.........[----------------------------------------------------------------------].........|
|..........................................................................................|
[------------------------------------------------------------------------------------------]