....+----------------------------------------}{--------------------------------------------+
.............................................||.............................................
.............................................||.............................................
.............................................||.............................................
.............................................||.............................................
.............................................||.............................................
.............................................||.............................................
+-------------------------------------}......||......{---------------------------------+....
......................................|......||......|......................................
......................................|......||......|......................................
......................................|......||......|......................................
......................................|......||......|......................................
......................................|......||......|......................................
......................................|......||......|......................................
....+--------------------------}......|......||......|......{------------------------------+
...............................|......|......||......|......|...............................
...............................|......|......||......|......|...............................
...............................|......|......||......|......|...............................
...............................|......|......||......|......|...............................
...............................|......|......||......|......|...............................
...............................|......|......||......|......|...............................
+-----------------------}......|......|......||......|......|......{-------------------+....
........................|......|......|......||......|......|......|........................
........................|......|......|......||......|......|......|........................
........................|......|......|......||......|......|......|........................
........................|......|......|......||......|......|......|........................
........................|......|......|......||......|......|......|........................
........................|......|......|......||......|......|......|........................
....+------------}......|......|......|......||......|......|......|......{----------------+
.................|......+......|......+......[]......|......+......|......+.................
.................|.............|.....................|.............|........................
.................|.............|.....................|.............|........................
.................|.............|.....................|.............|........................
.................|.............|.....................|.............|........................
.................|.............|.....................|.............|........................
.................|.............|.....................|.............|........................
.................|......+......|......+......{}......|......+......|......+.................
....+------------]......|......|......|......||......|......|......|......[----------------+
........................|......|......|......||......|......|......|........................
........................|......|......|......||......|......|......|........................
........................|......|......|......||......|......|......|........................
........................|......|......|......||......|......|......|........................
........................|......|......|......||......|......|......|........................
........................|......|......|......||......|......|......|........................
+-----------------------]......|......|......||......|......|......[-------------------+....
...............................|......|......||......|......|...............................
...............................|......|......||......|......|...............................
...............................|......|......||......|......|...............................
...............................|......|......||......|......|...............................
...............................|......|......||......|......|...............................
...............................|......|......||......|......|...............................
....+--------------------------]......|......||......|......[------------------------------+
......................................|......||......|......................................
......................................|......||......|......................................
......................................|......||......|......................................
......................................|......||......|......................................
......................................|......||......|......................................
......................................|......||......|......................................
+-------------------------------------]......||......[---------------------------------+....
.............................................||.............................................
.............................................||.............................................
.............................................||.............................................
.............................................||.............................................
.............................................||.............................................
.............................................||.............................................
....+----------------------------------------][--------------------------------------------+