+---------}{------------------}{------------------}{------------------}{-------------------+
|.........[]..................[]..................[]..................[]...................|
|...................{}..................{}..................{}..................{}.........|
|...................[]..................[]..................[]..................[].........|
|.........{}..................{}..................{}..................{}...................|
|.........[]..................[]..................[]..................[]...................|
|...................{}..................{}..................{}..................{}.........|
|...................[]..................[]..................[]..................[].........|
|.........{}..................{}..................{}..................{}...................|
|.........[]..................[]..................[]..................[]...................|
|...................{}..................{}..................{}..................{}.........|
|...................[]..................[]..................[]..................[].........|
|.........{}..................{}..................{}..................{}...................|
|.........[]..................[]..................[]..................[]...................|
|...................{}..................{}..................{}..................{}.........|
|...................[]..................[]..................[]..................[].........|
|.........{}..................{}..................{}..................{}...................|
|.........[]..................[]..................[]..................[]...................|
|...................{}..................{}..................{}..................{}.........|
|...................[]..................[]..................[]..................[].........|
|.........{}..................{}..................{}..................{}...................|
|.........[]..................[]..................[]..................[]...................|
|...................{}..................{}..................{}..................{}.........|
|...................[]..................[]..................[]..................[].........|
|.........{}..................{}..................{}..................{}...................|
|.........[]..................[]..................[]..................[]...................|
|...................{}..................{}..................{}..................{}.........|
|...................[]..................[]..................[]..................[].........|
|.........{}..................{}..................{}..................{}...................|
|.........[]..................[]..................[]..................[]...................|
|...................{}..................{}..................{}..................{}.........|
|...................[]..................[]..................[]..................[].........|
|.........{}..................{}..................{}..................{}...................|
|.........[]..................[]..................[]..................[]...................|
|...................{}..................{}..................{}..................{}.........|
|...................[]..................[]..................[]..................[].........|
|.........{}..................{}..................{}..................{}...................|
|.........[]..................[]..................[]..................[]...................|
|...................{}..................{}..................{}..................{}.........|
|...................[]..................[]..................[]..................[].........|
|.........{}..................{}..................{}..................{}...................|
|.........[]..................[]..................[]..................[]...................|
|...................{}..................{}..................{}..................{}.........|
|...................[]..................[]..................[]..................[].........|
|.........{}..................{}..................{}..................{}...................|
|.........[]..................[]..................[]..................[]...................|
|...................{}..................{}..................{}..................{}.........|
|...................[]..................[]..................[]..................[].........|
|.........{}..................{}..................{}..................{}...................|
|.........[]..................[]..................[]..................[]...................|
|...................{}..................{}..................{}..................{}.........|
|...................[]..................[]..................[]..................[].........|
|.........{}..................{}..................{}..................{}...................|
|.........[]..................[]..................[]..................[]...................|
|...................{}..................{}..................{}..................{}.........|
|...................[]..................[]..................[]..................[].........|
|.........{}..................{}..................{}..................{}...................|
|.........[]..................[]..................[]..................[]...................|
|...................{}..................{}..................{}..................{}.........|
|...................[]..................[]..................[]..................[].........|
|.........{}..................{}..................{}..................{}...................|
|.........[]..................[]..................[]..................[]...................|
|...................{}..................{}..................{}..................{}.........|
|...................[]..................[]..................[]..................[].........|
|.........{}..................{}..................{}..................{}...................|
+---------][------------------][------------------][------------------][-------------------+