{---------------------}{---------------------}{---------------------}{---------------------}
|.....................||.....................||.....................||.....................|
|.....................||.....................||.....................||.....................|
|.....................||.....................||.....................||.....................|
|.....................||.....................||.....................||.....................|
|.....................||.....................||.....................||.....................|
|.....................||.....................||.....................||.....................|
|.....................||.....................||.....................||.....................|
|.....................||.....................||.....................||.....................|
|.....................|[---}.................||.....................|[---}.................|
|.....................[----].................||.....................[----].................|
|...............{}...........................||...............{}...........................|
|...............||...........................||...............||...........................|
|...............||...........................||...............||...........................|
|...............||...........................||...............||...........................|
[---------------]|..........{----------------][---------------]|..........{----------------]
{----------------]..........|{---------------}{----------------]..........|{---------------}
|...........................||...............||...........................||...............|
|...........................||...............||...........................||...............|
|...........................||...............||...........................||...............|
|...........................[]...............||...........................[]...............|
|.................{----}.....................||.................{----}.....................|
|.................[---}|.....................|[-------}.........[---}|.....................|
|.....................||.....................[--------].............||.....................|
|.....................||............{}..............................||.....................|
|.....................||............||..............................||.....................|
|.....................||............||..............................||.....................|
|.....................||............||..............................||.....................|
|.....................||............||..............................||.....................|
|.....................||............||..............................||.....................|
|.....................||............||..............................||.....................|
|.....................||............||..............................||.....................|
[---------------------][------------]|.................{------------][---------------------]
{---------------------}{-------------].................|{-----------}{---------------------}
|.....................||...............................||...........||.....................|
|.....................||...............................||...........||.....................|
|.....................||...............................||...........||.....................|
|.....................||...............................||...........||.....................|
|.....................||...............................||...........||.....................|
|.....................||...............................||...........||.....................|
|.....................||...............................||...........||.....................|
|.....................||...............................[]...........||.....................|
|.....................||..............{-------}.....................||.....................|
|.....................|[---}..........[------}|.....................|[---}.................|
|.....................[----].................||.....................[----].................|
|...............{}...........................||...............{}...........................|
|...............||...........................||...............||...........................|
|...............||...........................||...............||...........................|
|...............||...........................||...............||...........................|
[---------------]|..........{----------------][---------------]|..........{----------------]
{----------------]..........|{---------------}{----------------]..........|{---------------}
|...........................||...............||...........................||...............|
|...........................||...............||...........................||...............|
|...........................||...............||...........................||...............|
|...........................[]...............||...........................[]...............|
|.................{----}.....................||.................{----}.....................|
|.................[---}|.....................||.................[---}|.....................|
|.....................||.....................||.....................||.....................|
|.....................||.....................||.....................||.....................|
|.....................||.....................||.....................||.....................|
|.....................||.....................||.....................||.....................|
|.....................||.....................||.....................||.....................|
|.....................||.....................||.....................||.....................|
|.....................||.....................||.....................||.....................|
|.....................||.....................||.....................||.....................|
[---------------------][---------------------][---------------------][---------------------]