+------------------------------------------------------------------------------------------+
|..........................................................................................|
|.........+---------+---------+---------+----------+---------+---------+---------+.........|
|.........|.........|.........|.........|..........|.........|.........|.........|.........|
|.........|.........|.........|.........|..........|.........|.........|.........|.........|
|.........+.........+.........|.........+..........+.........|.........+.........+.........|
|.............................|..............................|.............................|
|.............................|..............................|.............................|
|.............................|..............................|.............................|
|.............................|..............................|.............................|
|.............................|..............................|.............................|
|.........+.........+.........|.........+..........+.........|.........+.........+.........|
|.........|.........|.........|.........|..........|.........|.........|.........|.........|
|.........|.........|.........|.........|..........|.........|.........|.........|.........|
|.........+---------+--+....+-+--+....+-+----------+-+....+--+-+....+--+---------+.........|
|.........|.........|.........|.........|..........|.........|.........|.........|.........|
|.........|.........|.........|.........|..........|.........|.........|.........|.........|
|.........|.........+.........+.........|..........+.........+.........|.........+.........|
|.........|.............................|..............................|...................|
|.........|.............................|..............................|...................|
|.........|.............................|..............................|...................|
|.........|.............................|..............................|...................|
|.........|.............................|..............................|...................|
|.........|.........+.........+.........|..........+.........+.........|.........+.........|
|.........|.........|.........|.........|..........|.........|.........|.........|.........|
|.........|.........|.........|.........|..........|.........|.........|.........|.........|
|.........+--+....+-+---------+--+....+-+--+....+--+---------+-+....+--+-+....+--+.........|
|.........|.........|.........|.........|..........|.........|.........|.........|.........|
|.........|.........|.........|.........|..........|.........|.........|.........|.........|
|.........|.........+.........+.........|..........+.........+.........|.........+.........|
|.........|.............................|..............................|...................|
|.........|.............................|..............................|...................|
|.........|.............................|..............................|...................|
|.........|.............................|..............................|...................|
|.........|.............................|..............................|...................|
|.........|.............................|..............................|...................|
|.........|.........+.........+.........|..........+.........+.........|.........+.........|
|.........|.........|.........|.........|..........|.........|.........|.........|.........|
|.........|.........|.........|.........|..........|.........|.........|.........|.........|
|.........+--+....+-+--+....+-+---------+--+....+--+-+....+--+---------+-+....+--+.........|
|.........|.........|.........|.........|..........|.........|.........|.........|.........|
|.........|.........|.........|.........|..........|.........|.........|.........|.........|
|.........+.........+.........|.........+..........+.........|.........+.........+.........|
|.............................|..............................|.............................|
|.............................|..............................|.............................|
|.............................|..............................|.............................|
|.............................|..............................|.............................|
|.............................|..............................|.............................|
|.........+.........+.........|.........+..........+.........|.........+.........+.........|
|.........|.........|.........|.........|..........|.........|.........|.........|.........|
|.........|.........|.........|.........|..........|.........|.........|.........|.........|
|.........+---------+--+....+-+--+....+-+----------+-+....+--+-+....+--+---------+.........|
|.........|.........|.........|.........|..........|.........|.........|.........|.........|
|.........|.........|.........|.........|..........|.........|.........|.........|.........|
|.........|.........+.........+.........|..........+.........+.........|.........+.........|
|.........|.............................|..............................|...................|
|.........|.............................|..............................|...................|
|.........|.............................|..............................|...................|
|.........|.............................|..............................|...................|
|.........|.............................|..............................|...................|
|.........|.........+.........+.........|..........+.........+.........|.........+.........|
|.........|.........|.........|.........|..........|.........|.........|.........|.........|
|.........|.........|.........|.........|..........|.........|.........|.........|.........|
|.........+---------+---------+--------------------+---------+---------+---------+.........|
|..........................................................................................|
+------------------------------------------------------------------------------------------+