+------------------------------------------------------------------------------------------+
|..........................................................................................|
|..........................................................................................|
|..........................................................................................|
|..........................................................................................|
|..........................................................................................|
|..........................................................................................|
|..........................................................................................|
|..........................................................................................|
|..........................................................................................|
|..........................................................................................|
|..........................................................................................|
|..........................................................................................|
|..........................................................................................|
|..........................................................................................|
|..........................................................................................|
|..........................................................................................|
|..........................................................................................|
|..........................................................................................|
|..........................................................................................|
|..........................................................................................|
|..........................................................................................|
|..........................................................................................|
|..........................................................................................|
|..........................................................................................|
|..........................................................................................|
|..........................................................................................|
|..........................................................................................|
|..........................................................................................|
|..........................................................................................|
|..........................................................................................|
|..........................................................................................|
|...................{--------------------------------------------------}...................|
|...................[--------------------------------------------------]...................|
|..........................................................................................|
|..........................................................................................|
|..........................................................................................|
|..........................................................................................|
|..........................................................................................|
|..........................................................................................|
|..........................................................................................|
|..........................................................................................|
|..........................................................................................|
|..........................................................................................|
|..........................................................................................|
|..........................................................................................|
|..........................................................................................|
|..........................................................................................|
|..........................................................................................|
|..........................................................................................|
|..........................................................................................|
|..........................................................................................|
|..........................................................................................|
|..........................................................................................|
|..........................................................................................|
|..........................................................................................|
|..........................................................................................|
|..........................................................................................|
|..........................................................................................|
|..........................................................................................|
|..........................................................................................|
|..........................................................................................|
|..........................................................................................|
|..........................................................................................|
|..........................................................................................|
+------------------------------------------------------------------------------------------+