.....................||....||....||....||....||....||....||....||....||.....................
.....................||....||....||....||....||....||....||....||....||.....................
-----------}.........||....||....||....||....||....||....||....||....||.........{-----------
-----------].........||....||....||....||....||....||....||....||....||.........[-----------
.....................[]....||....||....||....||....||....||....||....[].....................
...........................||....||....||....||....||....||....||...........................
...........................||....||....||....||....||....||....||...........................
...........................||....||....||....||....||....||....||...........................
-----------------}.........||....||....||....||....||....||....||.........{-----------------
-----------------].........||....||....||....||....||....||....||.........[-----------------
...........................[]....||....||....||....||....||....[]...........................
.................................||....||....||....||....||.................................
.................................||....||....||....||....||.................................
.................................||....||....||....||....||.................................
-----------------------}.........||....||....||....||....||.........{-----------------------
-----------------------].........||....||....||....||....||.........[-----------------------
.................................[]....||....||....||....[].................................
.......................................||....||....||.......................................
.......................................||....||....||.......................................
.......................................||....||....||.......................................
-----------------------------}.........||....||....||.........{-----------------------------
-----------------------------].........||....||....||.........[-----------------------------
.......................................[]....||....[].......................................
.............................................||.............................................
.............................................||.............................................
.............................................||.............................................
-----------------------------------}.........||.........{-----------------------------------
-----------------------------------].........||.........[-----------------------------------
.............................................||.............................................
.............................................||.............................................
.............................................||.............................................
.............................................||.............................................
---------------------------------------------][---------------------------------------------
---------------------------------------------}{---------------------------------------------
.............................................||.............................................
.............................................||.............................................
.............................................||.............................................
.............................................||.............................................
-----------------------------------}.........||.........{-----------------------------------
-----------------------------------].........||.........[-----------------------------------
.............................................||.............................................
.............................................||.............................................
.............................................||.............................................
.......................................{}....||....{}.......................................
-----------------------------}.........||....||....||.........{-----------------------------
-----------------------------].........||....||....||.........[-----------------------------
.......................................||....||....||.......................................
.......................................||....||....||.......................................
.......................................||....||....||.......................................
.................................{}....||....||....||....{}.................................
-----------------------}.........||....||....||....||....||.........{-----------------------
-----------------------].........||....||....||....||....||.........[-----------------------
.................................||....||....||....||....||.................................
.................................||....||....||....||....||.................................
.................................||....||....||....||....||.................................
...........................{}....||....||....||....||....||....{}...........................
-----------------}.........||....||....||....||....||....||....||.........{-----------------
-----------------].........||....||....||....||....||....||....||.........[-----------------
...........................||....||....||....||....||....||....||...........................
...........................||....||....||....||....||....||....||...........................
...........................||....||....||....||....||....||....||...........................
.....................{}....||....||....||....||....||....||....||....{}.....................
-----------}.........||....||....||....||....||....||....||....||....||.........{-----------
-----------].........||....||....||....||....||....||....||....||....||.........[-----------
.....................||....||....||....||....||....||....||....||....||.....................
.....................||....||....||....||....||....||....||....||....||.....................