{----+--------------------------------------------------------------------------------+----}
|....|................................................................................|....|
|....|................................................................................|....|
|....|................................................................................|....|
|....|................................................................................|....|
|....|................................................................................|....|
|....|................................................................................|....|
|....[----+.{}.{}.{}.{}.{}.{}.{}.{}.{}.{}.{}.{}.{}.{}.{}.{}.{}.{}.{}.{}.{}.{}.{}.+----]....|
|.........|.||.||.||.||.||.||.||.||.||.||.||.||.||.||.||.||.||.||.||.||.||.||.||.|.........|
|.........|.||.||.||.||.||.||.||.||.||.||.||.||.||.||.||.||.||.||.||.||.||.||.||.|.........|
|.........|.||.||.||.||.||.||.||.||.||.||.||.||.||.||.||.||.||.||.||.||.||.||.||.|.........|
|.........|.||.||.||.||.||.||.||.||.||.||.||.||.||.||.||.||.||.||.||.||.||.||.||.|.........|
|.........|.||.||.||.||.||.||.||.||.||.||.||.||.||.||.||.||.||.||.||.||.||.||.||.|.........|
|.........|.||.||.||.||.||.||.||.||.||.||.||.||.||.||.||.||.||.||.||.||.||.||.||.|.........|
|.........|.||.||.||.||.||.||.||.||.||.||.||.||.||.||.||.||.||.||.||.||.||.||.||.|.........|
|.........|.||.||.||.||.||.||.||.||.||.||.||.||.||.||.||.||.||.||.||.||.||.||.||.|.........|
|.........|.||.||.||.||.||.||.||.||.||.||.||.||.||.||.||.||.||.||.||.||.||.||.||.|.........|
|.........|.||.||.||.||.||.||.||.||.||.||.||.||.||.||.||.||.||.||.||.||.||.||.||.|.........|
|.........|.||.||.||.||.||.||.||.||.||.||.||.||.||.||.||.||.||.||.||.||.||.||.||.|.........|
|.........|.||.||.||.||.||.||.||.||.||.||.||.||.||.||.||.||.||.||.||.||.||.||.||.|.........|
|.........|.||.||.||.||.||.||.||.||.||.||.||.||.||.||.||.||.||.||.||.||.||.||.||.|.........|
|.........|.||.||.||.||.||.||.||.||.||.||.||.||.||.||.||.||.||.||.||.||.||.||.||.|.........|
|.........|.||.||.||.||.||.||.||.||.||.||.||.||.||.||.||.||.||.||.||.||.||.||.||.|.........|
|.........|.||.||.||.||.||.||.||.||.||.||.||.||.||.||.||.||.||.||.||.||.||.||.||.|.........|
|.........|.||.||.||.||.||.||.||.||.||.||.||.||.||.||.||.||.||.||.||.||.||.||.||.|.........|
|.........|.||.||.||.||.||.||.||.||.||.||.||.||.||.||.||.||.||.||.||.||.||.||.||.|.........|
|.........|.||.||.||.||.||.||.||.||.||.||.||.||.||.||.||.||.||.||.||.||.||.||.||.|.........|
|.........|.||.||.||.||.||.||.||.||.||.||.||.||.||.||.||.||.||.||.||.||.||.||.||.|.........|
|.........|.||.||.||.||.||.||.||.||.||.||.||.||.||.||.||.||.||.||.||.||.||.||.||.|.........|
|.........|.||.||.||.||.||.||.||.||.||.||.||.||.||.||.||.||.||.||.||.||.||.||.||.|.........|
|.........|.||.||.||.||.||.||.||.||.||.||.||.||.||.||.||.||.||.||.||.||.||.||.||.|.........|
|.........|.||.||.||.||.||.||.||.||.||.||.||.||.||.||.||.||.||.||.||.||.||.||.||.|.........|
|.........|.||.||.||.||.||.||.||.||.||.||.||.||.||.||.||.||.||.||.||.||.||.||.||.|.........|
|.........|.||.||.||.||.||.||.||.||.||.||.||.||.||.||.||.||.||.||.||.||.||.||.||.|.........|
|.........|.||.||.||.||.||.||.||.||.||.||.||.||.||.||.||.||.||.||.||.||.||.||.||.|.........|
|.........|.||.||.||.||.||.||.||.||.||.||.||.||.||.||.||.||.||.||.||.||.||.||.||.|.........|
|.........|.||.||.||.||.||.||.||.||.||.||.||.||.||.||.||.||.||.||.||.||.||.||.||.|.........|
|.........|.||.||.||.||.||.||.||.||.||.||.||.||.||.||.||.||.||.||.||.||.||.||.||.|.........|
|.........|.||.||.||.||.||.||.||.||.||.||.||.||.||.||.||.||.||.||.||.||.||.||.||.|.........|
|.........|.||.||.||.||.||.||.||.||.||.||.||.||.||.||.||.||.||.||.||.||.||.||.||.|.........|
|.........|.||.||.||.||.||.||.||.||.||.||.||.||.||.||.||.||.||.||.||.||.||.||.||.|.........|
|.........|.||.||.||.||.||.||.||.||.||.||.||.||.||.||.||.||.||.||.||.||.||.||.||.|.........|
|.........|.||.||.||.||.||.||.||.||.||.||.||.||.||.||.||.||.||.||.||.||.||.||.||.|.........|
|.........|.||.||.||.||.||.||.||.||.||.||.||.||.||.||.||.||.||.||.||.||.||.||.||.|.........|
|.........|.||.||.||.||.||.||.||.||.||.||.||.||.||.||.||.||.||.||.||.||.||.||.||.|.........|
|.........|.||.||.||.||.||.||.||.||.||.||.||.||.||.||.||.||.||.||.||.||.||.||.||.|.........|
|.........|.||.||.||.||.||.||.||.||.||.||.||.||.||.||.||.||.||.||.||.||.||.||.||.|.........|
|.........|.||.||.||.||.||.||.||.||.||.||.||.||.||.||.||.||.||.||.||.||.||.||.||.|.........|
|.........|.||.||.||.||.||.||.||.||.||.||.||.||.||.||.||.||.||.||.||.||.||.||.||.|.........|
|.........|.||.||.||.||.||.||.||.||.||.||.||.||.||.||.||.||.||.||.||.||.||.||.||.|.........|
|.........|.||.||.||.||.||.||.||.||.||.||.||.||.||.||.||.||.||.||.||.||.||.||.||.|.........|
|.........|.||.||.||.||.||.||.||.||.||.||.||.||.||.||.||.||.||.||.||.||.||.||.||.|.........|
|.........|.||.||.||.||.||.||.||.||.||.||.||.||.||.||.||.||.||.||.||.||.||.||.||.|.........|
|.........|.||.||.||.||.||.||.||.||.||.||.||.||.||.||.||.||.||.||.||.||.||.||.||.|.........|
|.........|.||.||.||.||.||.||.||.||.||.||.||.||.||.||.||.||.||.||.||.||.||.||.||.|.........|
|.........|.||.||.||.||.||.||.||.||.||.||.||.||.||.||.||.||.||.||.||.||.||.||.||.|.........|
|.........|.||.||.||.||.||.||.||.||.||.||.||.||.||.||.||.||.||.||.||.||.||.||.||.|.........|
|.........|.||.||.||.||.||.||.||.||.||.||.||.||.||.||.||.||.||.||.||.||.||.||.||.|.........|
|.........+.[].[].[].[].[].[].[].[].[].[].[].[].[].[].[].[].[].[].[].[].[].[].[].+.........|
|..........................................................................................|
|..........................................................................................|
|..........................................................................................|
|..........................................................................................|
|..........................................................................................|
|..........................................................................................|
[------------------------------------------------------------------------------------------]