+------------------------------------------------------------------------------------------+
|..........................................................................................|
|..........................................................................................|
|..........................................................................................|
|..........................................................................................|
|.....+..............................................................................+.....|
|.....[------------------------------------------------------------------------------].....|
|..........................................................................................|
|..........................................................................................|
|..........................................................................................|
|..........................................................................................|
|..........................................................................................|
|....+}.....{+...+}.....{+...+}.....{+....{------}....+}.....{+...+}.....{+...+}.....{+....|
|.....|.....|.....|.....|.....|.....|.....|######|.....|.....|.....|.....|.....|.....|.....|
|.....|.....|.....|.....|.....|.....|.....|######|.....|.....|.....|.....|.....|.....|.....|
|.....|.....|.....|.....|.....|.....|.....|######|.....|.....|.....|.....|.....|.....|.....|
|.....|.....|.....|.....|.....|.....|.....|######|.....|.....|.....|.....|.....|.....|.....|
|.....|.....|.....|.....|.....|.....|.....|######|.....|.....|.....|.....|.....|.....|.....|
|.....|.....|.....|.....|.....|.....|.....|######|.....|.....|.....|.....|.....|.....|.....|
|.....|.....|.....|.....|.....|.....|.....|######|.....|.....|.....|.....|.....|.....|.....|
|.....|.....|.....|.....|.....|.....|.....|######|.....|.....|.....|.....|.....|.....|.....|
|.....|.....|.....|.....|.....|.....|.....|######|.....|.....|.....|.....|.....|.....|.....|
|.....|.....|.....|.....|.....|.....|.....|######|.....|.....|.....|.....|.....|.....|.....|
|.....|.....|.....|.....|.....|.....|.....|######|.....|.....|.....|.....|.....|.....|.....|
|.....|.....|.....|.....|.....|.....|.....|######|.....|.....|.....|.....|.....|.....|.....|
|.....|.....|.....|.....|.....|.....|.....|######|.....|.....|.....|.....|.....|.....|.....|
|.....|.....|.....|.....|.....|.....|.....|######|.....|.....|.....|.....|.....|.....|.....|
|.....|.....|.....|.....|.....|.....|.....|######|.....|.....|.....|.....|.....|.....|.....|
|.....|.....|.....|.....|.....|.....|.....|######|.....|.....|.....|.....|.....|.....|.....|
|.....|.....|.....|.....|.....|.....|.....|######|.....|.....|.....|.....|.....|.....|.....|
|.....|.....|.....|.....|.....|.....|.....|######|.....|.....|.....|.....|.....|.....|.....|
|.....|.....|.....|.....|.....|.....|.....|######|.....|.....|.....|.....|.....|.....|.....|
|.....|.....|.....|.....|.....|.....|.....|######|.....|.....|.....|.....|.....|.....|.....|
|.....|.....|.....|.....|.....|.....|.....|######|.....|.....|.....|.....|.....|.....|.....|
|.....|.....|.....|.....|.....|.....|.....|######|.....|.....|.....|.....|.....|.....|.....|
|.....|.....|.....|.....|.....|.....|.....|######|.....|.....|.....|.....|.....|.....|.....|
|.....|.....|.....|.....|.....|.....|.....|######|.....|.....|.....|.....|.....|.....|.....|
|.....|.....|.....|.....|.....|.....|.....|######|.....|.....|.....|.....|.....|.....|.....|
|.....|.....|.....|.....|.....|.....|.....|######|.....|.....|.....|.....|.....|.....|.....|
|.....|.....|.....|.....|.....|.....|.....|######|.....|.....|.....|.....|.....|.....|.....|
|.....|.....|.....|.....|.....|.....|.....|######|.....|.....|.....|.....|.....|.....|.....|
|.....|.....|.....|.....|.....|.....|.....|######|.....|.....|.....|.....|.....|.....|.....|
|.....|.....|.....|.....|.....|.....|.....|######|.....|.....|.....|.....|.....|.....|.....|
|.....|.....|.....|.....|.....|.....|.....|######|.....|.....|.....|.....|.....|.....|.....|
|.....|.....|.....|.....|.....|.....|.....|######|.....|.....|.....|.....|.....|.....|.....|
|.....|.....|.....|.....|.....|.....|.....|######|.....|.....|.....|.....|.....|.....|.....|
|.....|.....|.....|.....|.....|.....|.....|######|.....|.....|.....|.....|.....|.....|.....|
|.....|.....|.....|.....|.....|.....|.....|######|.....|.....|.....|.....|.....|.....|.....|
|.....|.....|.....|.....|.....|.....|.....|######|.....|.....|.....|.....|.....|.....|.....|
|.....|.....|.....|.....|.....|.....|.....|######|.....|.....|.....|.....|.....|.....|.....|
|.....|.....|.....|.....|.....|.....|.....|######|.....|.....|.....|.....|.....|.....|.....|
|.....|.....|.....|.....|.....|.....|.....|######|.....|.....|.....|.....|.....|.....|.....|
|.....|.....|.....|.....|.....|.....|.....|######|.....|.....|.....|.....|.....|.....|.....|
|.....[+...+].....[+...+].....[+...+].....[------].....[+...+].....[+...+].....[+...+].....|
|..........................................................................................|
|..........................................................................................|
|..........................................................................................|
|..........................................................................................|
|..........................................................................................|
|.....{------------------------------------------------------------------------------}.....|
|.....+..............................................................................+.....|
|..........................................................................................|
|..........................................................................................|
|..........................................................................................|
|..........................................................................................|
+------------------------------------------------------------------------------------------+