..{-----------------}....{-----------------}....{-----------------}....{-----------------}..
..|.................|....|.................|....|.................|....|.................|..
..|.................|....|.................|....|.................|....|.................|..
..|.................|....|.................|....|.................|....|.................|..
..|.................|....|.................|....|.................|....|.................|..
..|.................|....|.................|....|.................|....|.................|..
..|.................|....|.................|....|.................|....|.................|..
..|.................|....|.................|....|.................|....|.................|..
..|.................|....|.................|....|.................|....|.................|..
..|.................|....|.................|....|.................|....|.................|..
..|.................|....|.................|....|.................|....|.................|..
..|.................|....|.................|....|.................|....|.................|..
..|.................|....|.................|....|.................|....|.................|..
..[+...............+]....[+...............+]....[+...............+]....[+...............+]..
............................................................................................
............................................................................................
..{+...............+}....{+...............+}....{+...............+}....{+...............+}..
..|.................|....|.................|....|.................|....|.................|..
..|.................|....|.................|....|.................|....|.................|..
..|.................|....|.................|....|.................|....|.................|..
..|.................|....|.................|....|.................|....|.................|..
..|.................|....|.................|....|.................|....|.................|..
..|.................|....|.................|....|.................|....|.................|..
..|.................|....|.................|....|.................|....|.................|..
..|.................|....|.................|....|.................|....|.................|..
..|.................|....|.................|....|.................|....|.................|..
..|.................|....|.................|....|.................|....|.................|..
..|.................|....|.................|....|.................|....|.................|..
..|.................|....|.................|....|.................|....|.................|..
..[-----------------]....[-----------------]....[-----------------]....[-----------------]..
............................................................................................
............................................................................................
............................................................................................
............................................................................................
............................................................................................
............................................................................................
............................................................................................
............................................................................................
..{-----------------}....{-----------------}....{-----------------}....{-----------------}..
..|.................|....|.................|....|.................|....|.................|..
..|.................|....|.................|....|.................|....|.................|..
..|.................|....|.................|....|.................|....|.................|..
..|.................|....|.................|....|.................|....|.................|..
..|.................|....|.................|....|.................|....|.................|..
..|.................|....|.................|....|.................|....|.................|..
..|.................|....|.................|....|.................|....|.................|..
..|.................|....|.................|....|.................|....|.................|..
..|.................|....|.................|....|.................|....|.................|..
..|.................|....|.................|....|.................|....|.................|..
..|.................|....|.................|....|.................|....|.................|..
..[+...............+]....[+...............+]....[+...............+]....[+...............+]..
............................................................................................
............................................................................................
..{+...............+}....{+...............+}....{+...............+}....{+...............+}..
..|.................|....|.................|....|.................|....|.................|..
..|.................|....|.................|....|.................|....|.................|..
..|.................|....|.................|....|.................|....|.................|..
..|.................|....|.................|....|.................|....|.................|..
..|.................|....|.................|....|.................|....|.................|..
..|.................|....|.................|....|.................|....|.................|..
..|.................|....|.................|....|.................|....|.................|..
..|.................|....|.................|....|.................|....|.................|..
..|.................|....|.................|....|.................|....|.................|..
..|.................|....|.................|....|.................|....|.................|..
..|.................|....|.................|....|.................|....|.................|..
..[-----------------]....[-----------------]....[-----------------]....[-----------------]..