{------------------------------------------------------------------------------------------}
|..........................................................................................|
|..........................................................................................|
|..........................................................................................|
|...........................................+..+...........................................|
|....{--------------------------------------]..[--------------------------------------}....|
|....|................................................................................|....|
|....[--------------------------------------}..{--------------------------------------]....|
|...........................................+..+...........................................|
|..........................................................................................|
|..........................................................................................|
|..........................................................................................|
|..........................................................................................|
|..........................................................................................|
|..........................................................................................|
|..........................................................................................|
|..........................................................................................|
|..........................................................................................|
|..........................................................................................|
|...............................{----}.{----}..{----}.{----}...............................|
|...............................|....+.+....|..|....+.+....|...............................|
|...............................|...........|..|...........|...............................|
|...............................|...........|..|...........|...............................|
|...............................|...........|..|...........|...............................|
|...............................[+.........+]..[+.........+]...............................|
|..........................................................................................|
|...............................{+.........+}..{+.........+}...............................|
|...............................|...........|..|...........|...............................|
|...............................|...........|..|...........|...............................|
|...............................|...........|..|...........|...............................|
|...............................|....+.+....|..|....+.+....|...............................|
|...............................[----].[----]..[----].[----]...............................|
|..........................................................................................|
|..........................................................................................|
|...............................{----}.{----}..{----}.{----}...............................|
|...............................|....+.+....|..|....+.+....|...............................|
|...............................|...........|..|...........|...............................|
|...............................|...........|..|...........|...............................|
|...............................|...........|..|...........|...............................|
|...............................[+.........+]..[+.........+]...............................|
|..........................................................................................|
|...............................{+.........+}..{+.........+}...............................|
|...............................|...........|..|...........|...............................|
|...............................|...........|..|...........|...............................|
|...............................|...........|..|...........|...............................|
|...............................|....+.+....|..|....+.+....|...............................|
|...............................[----].[----]..[----].[----]...............................|
|..........................................................................................|
|..........................................................................................|
|..........................................................................................|
|..........................................................................................|
|..........................................................................................|
|..........................................................................................|
|..........................................................................................|
|..........................................................................................|
|..........................................................................................|
|..........................................................................................|
|...........................................+..+...........................................|
|....{--------------------------------------]..[--------------------------------------}....|
|....|................................................................................|....|
|....[--------------------------------------}..{--------------------------------------]....|
|...........................................+..+...........................................|
|..........................................................................................|
|..........................................................................................|
|..........................................................................................|
[------------------------------------------------------------------------------------------]