{-------------------------------------------}..{-------------------------------------------}
|...........................................+..+...........................................|
|..........................................................................................|
|..........................................................................................|
|...........................................+..+...........................................|
|...........................................|..|...........................................|
|...........................................|..|...........................................|
|...........................................|..|...........................................|
|...........................................|..|...........................................|
|...........................................|..|...........................................|
|...........................................|..|...........................................|
|...........................................|..|...........................................|
|...........................................|..|...........................................|
|...........................................|..|...........................................|
|...........................................|..|...........................................|
|...........................................|..|...........................................|
|...........................................|..|...........................................|
|...........................................|..|...........................................|
|...........................................|..|...........................................|
|...........................................|..|...........................................|
|...........................................|..|...........................................|
|...........................................|..|...........................................|
|...........................................|..|...........................................|
|...........................................|..|...........................................|
|...........................................|..|...........................................|
|...........................................|..|...........................................|
|...........................................|..|...........................................|
|...........................................|..|...........................................|
|...........................................|..|...........................................|
|...........................................|..|...........................................|
|...........................................|..|...........................................|
[+..+---------------------------------------]..[---------------------------------------+..+]
............................................................................................
............................................................................................
{+..+---------------------------------------}..{---------------------------------------+..+}
|...........................................|..|...........................................|
|...........................................|..|...........................................|
|...........................................|..|...........................................|
|...........................................|..|...........................................|
|...........................................|..|...........................................|
|...........................................|..|...........................................|
|...........................................|..|...........................................|
|...........................................|..|...........................................|
|...........................................|..|...........................................|
|...........................................|..|...........................................|
|...........................................|..|...........................................|
|...........................................|..|...........................................|
|...........................................|..|...........................................|
|...........................................|..|...........................................|
|...........................................|..|...........................................|
|...........................................|..|...........................................|
|...........................................|..|...........................................|
|...........................................|..|...........................................|
|...........................................|..|...........................................|
|...........................................|..|...........................................|
|...........................................|..|...........................................|
|...........................................|..|...........................................|
|...........................................|..|...........................................|
|...........................................|..|...........................................|
|...........................................|..|...........................................|
|...........................................|..|...........................................|
|...........................................+..+...........................................|
|..........................................................................................|
|..........................................................................................|
|...........................................+..+...........................................|
[-------------------------------------------]..[-------------------------------------------]