+------------------------------------------------------------------------------+
|..................|...........................................................|
|..................|...........................................................|
|..................|...........................................................|
|..................|...........................................................|
|..................|...........................................................|
|..................|...........................................................|
|..................|...........................................................|
|..................|...........................................................|
|..................|...........................................................|
|..................|...........................................................|
|..................|...........................................................|
|..................|...........................................................|
|..................|...........................................................|
|..................|...................----------------------------------------|
|..................|...........................................................|
|..................|...........................................................|
|..................|...........................................................|
|..................|...........................................................|
|..................|...........................................................|
|..................|...........................................................|
|..................|...........................................................|
|..................|...........................................................|
|..................|...........................................................|
|..................|...........................................................|
|..................|...........................................................|
|..................|...........................................................|
|..................|...........................................................|
|..................|...........................................................|
|..................|........................................|..................|
|...........................................................|..................|
|...........................................................|..................|
|...........................................................|..................|
|...........................................................|..................|
|...........................................................|..................|
|...........................................................|..................|
|...........................................................|..................|
|...........................................................|..................|
|...........................................................|..................|
|...........................................................|..................|
|...........................................................|..................|
|...........................................................|..................|
|...........................................................|..................|
|...........................................................|..................|
|...........................................................|..................|
|---------------------------------------....................|..................|
|...........................................................|..................|
|...........................................................|..................|
|...........................................................|..................|
|...........................................................|..................|
|...........................................................|..................|
|...........................................................|..................|
|...........................................................|..................|
|...........................................................|..................|
|...........................................................|..................|
|...........................................................|..................|
|...........................................................|..................|
|...........................................................|..................|
|...........................................................|..................|
+------------------------------------------------------------------------------+