+------------------------------------------------------------------------------------------+
|..........................................................................................|
|..........................................................................................|
|..........................................................................................|
|..........................................................................................|
|..........................................................................................|
|..........................................................................................|
|..........................................................................................|
|......................{}.........................................{}.......................|
|......................||.........................................||.......................|
|......................||.........................................||.......................|
|......................||.........................................||.......................|
|......................||.........................................||.......................|
|......................||.........................................||.......................|
|......................||.........................................||.......................|
|......................||.........................................||.......................|
|......................||.........................................||.......................|
|......................||.........................................||.......................|
|......................||.........................................||.......................|
|......................||.........................................||.......................|
|......................||.........................................||.......................|
|......................||.........................................||.......................|
|......................||.........................................||.......................|
|......................||.........................................||.......................|
|......................||.........................................||.......................|
|......................||.........................................||.......................|
|......................||.........................................||.......................|
|......................||.........................................||.......................|
|......................||.........................................||.......................|
|......................||.........................................||.......................|
|......................||.........................................||.......................|
|......................||.........................................||.......................|
|......................||.........................................||.......................|
|......................||.........................................||.......................|
|......................||.........................................||.......................|
|......................||.........................................||.......................|
|......................||.........................................||.......................|
|......................||.........................................||.......................|
|......................||.........................................||.......................|
|......................||.........................................||.......................|
|......................||.........................................||.......................|
|......................||.........................................||.......................|
|......................||.........................................||.......................|
|......................||.........................................||.......................|
|......................||.........................................||.......................|
|......................||.........................................||.......................|
|......................||.........................................||.......................|
|......................||.........................................||.......................|
|......................||.........................................||.......................|
|......................||.........................................||.......................|
|......................||.........................................||.......................|
|......................||.........................................||.......................|
|......................||.........................................||.......................|
|......................||.........................................||.......................|
|......................||.........................................||.......................|
|......................||.........................................||.......................|
|......................||.........................................||.......................|
|......................[].........................................[].......................|
|..........................................................................................|
|..........................................................................................|
|..........................................................................................|
|..........................................................................................|
|..........................................................................................|
|..........................................................................................|
|..........................................................................................|
+------------------------------------------------------------------------------------------+