+------------------+-----------------------------------------------------------+
|..................|...........................................................|
|..................|...........................................................|
|..................|...........................................................|
|..................|...........................................................|
|..................|...........................................................|
|..................|...........................................................|
|..................|...........................................................|
|..................|...........................................................|
|..................|...........................................................|
|..................|...........................................................|
|..................|...........................................................|
|..................|...........................................................|
|..................|...........................................................|
|..................|...................+---------------------------------------+
|..................|...........................................................|
|..................|...........................................................|
|..................|...........................................................|
|..................|...........................................................|
|..................|...........................................................|
|..................|...........................................................|
|..................|...........................................................|
|..................|...........................................................|
|..................|...........................................................|
|..................|...........................................................|
|..................|...........................................................|
|..................|...........................................................|
|..................|...........................................................|
|..................|...........................................................|
|..................+........................................+..................|
|...........................................................|..................|
|...........................................................|..................|
|...........................................................|..................|
|...........................................................|..................|
|...........................................................|..................|
|...........................................................|..................|
|...........................................................|..................|
|...........................................................|..................|
|...........................................................|..................|
|...........................................................|..................|
|...........................................................|..................|
|...........................................................|..................|
|...........................................................|..................|
|...........................................................|..................|
|...........................................................|..................|
+--------------------------------------+....................|..................|
|...........................................................|..................|
|...........................................................|..................|
|...........................................................|..................|
|...........................................................|..................|
|...........................................................|..................|
|...........................................................|..................|
|...........................................................|..................|
|...........................................................|..................|
|...........................................................|..................|
|...........................................................|..................|
|...........................................................|..................|
|...........................................................|..................|
|...........................................................|..................|
+-----------------------------------------------------------+------------------+